55 20
192 576
6 6 6 6 6 6 6 6 6 6 6 6 6 6 6 6 6 6 6 6 6 6 6 6 6 6 6 6 6 6 6 6 6 6 6 6 6 6 6 6 6 6 6 6 6 6 6 6 6 6 6 6 6 6 6
6 0 0 0 0 1 0 0 0 0 0 0 1 0 0 0 10 10 0 0 0 0 0 0 0 0 0 0 0 0 3 3 3 0 0 0 7 8 9 9 9 9 9 9 9 9 9 9 9 9 9 9 9 9 6
6 0 0 0 0 1 0 0 0 0 0 0 1 0 0 0 10 10 10 0 0 0 0 0 0 0 0 0 0 0 3 3 3 0 0 0 7 8 9 9 9 9 9 9 9 9 9 9 9 9 9 9 9 9 6
6 0 0 0 0 1 0 0 0 1 0 0 0 0 0 1 0 10 10 10 0 0 0 0 0 0 0 0 0 0 3 3 3 0 0 0 7 8 4 4 4 4 4 9 9 5 5 5 5 5 5 5 9 9 6
6 0 0 0 0 1 1 0 0 1 0 0 0 0 0 1 0 0 10 10 10 0 0 0 0 0 0 0 0 0 3 3 3 0 0 0 7 8 4 4 4 4 4 9 9 5 5 5 5 5 5 5 9 9 6
6 0 0 0 0 1 0 0 0 1 1 1 1 1 1 1 0 0 0 10 10 10 0 0 0 0 0 0 0 0 3 3 3 0 0 0 7 8 4 4 4 4 4 9 9 5 5 5 5 5 5 5 9 9 6
6 0 0 0 0 1 0 0 1 1 0 0 1 0 0 1 0 0 0 0 10 10 10 0 0 0 0 0 0 0 3 3 3 0 0 0 7 8 4 4 4 4 4 9 9 5 5 5 5 5 5 5 9 9 6
6 0 0 0 0 1 0 1 1 0 0 0 0 0 0 1 0 0 0 0 0 10 10 10 10 0 0 0 0 0 11 12 13 0 0 0 7 8 4 4 4 4 4 9 9 5 5 5 5 5 5 5 9 9 6
6 0 0 0 0 1 0 1 0 0 0 0 0 1 1 1 0 0 0 0 0 0 10 10 10 10 10 10 10 10 2 2 2 10 10 10 4 4 4 4 4 4 4 5 5 5 5 5 5 5 5 5 9 9 6
6 0 0 0 0 0 0 0 0 0 0 0 0 0 0 1 0 0 0 0 0 0 0 10 10 10 10 10 10 10 2 2 2 10 10 10 4 4 4 4 4 4 4 5 5 5 5 5 5 5 5 5 9 9 6
6 0 0 0 0 1 0 0 0 1 1 1 0 0 0 1 0 0 0 0 0 0 0 0 10 10 10 10 10 10 14 15 16 10 10 10 4 4 4 4 4 4 4 5 5 5 5 5 5 5 5 5 9 9 6
6 0 0 0 0 1 0 0 0 1 0 1 1 1 0 1 0 0 0 0 0 0 0 0 0 0 0 0 0 0 3 3 3 0 0 0 7 8 4 4 4 4 4 9 9 5 5 5 5 5 5 5 9 9 6
6 0 0 0 0 1 1 1 1 1 0 0 0 1 0 1 0 0 0 0 0 0 0 0 0 0 0 0 0 0 3 3 3 0 0 0 7 8 4 4 4 4 4 9 9 5 5 5 5 5 5 5 9 9 6
6 0 0 0 0 1 0 0 0 1 0 0 0 1 0 1 0 0 0 0 0 0 0 0 0 0 0 0 0 0 3 3 3 0 0 0 7 8 4 4 4 4 4 9 9 5 5 5 5 5 5 5 9 9 6
6 0 0 0 0 1 0 0 0 1 1 1 0 1 0 1 0 0 0 0 0 0 0 0 0 0 0 0 0 0 3 3 3 0 0 0 7 8 4 4 4 4 4 9 9 5 5 5 5 5 5 5 9 9 6
6 0 0 0 0 1 0 1 0 1 0 0 0 1 0 1 0 0 0 0 0 0 0 0 0 0 0 0 0 0 3 3 3 0 0 0 7 8 4 4 4 4 4 9 9 5 5 5 5 5 5 5 9 9 6
6 0 0 0 0 1 0 1 1 1 0 0 0 1 0 1 0 0 0 0 0 0 0 0 0 0 0 0 0 0 3 3 3 0 0 0 7 8 4 4 4 4 4 9 9 5 5 5 5 5 5 5 9 9 6
6 0 0 0 0 0 0 0 0 0 0 1 0 0 0 1 0 0 0 0 0 0 0 0 0 0 0 0 0 0 3 3 3 0 0 0 7 8 9 9 9 9 9 9 9 9 9 9 9 9 9 9 9 9 6
6 0 0 0 0 0 0 0 0 0 0 1 0 0 0 1 0 0 0 0 0 0 0 0 0 0 0 0 0 0 3 3 3 0 0 0 7 8 9 9 9 9 9 9 9 9 9 9 9 9 9 9 9 9 6
6 6 6 6 6 6 6 6 6 6 6 6 6 6 6 6 6 6 6 6 6 6 6 6 6 6 6 6 6 6 6 6 6 6 6 6 6 6 6 6 6 6 6 6 6 6 6 6 6 6 6 6 6 6 6
